###################
#............#...A#
#....#######.#...b#
#....#.......#....#
#B...#.#######....#
#a...#............#
###################
