#################
#a.............b#
#...............#
#...######.....C#
#.........#.....#
#c.d.......#ED..#
#..........A#...#
#......#.....#..#
#......#........#
#B.....#e.......#
#################
