########
#..aABb#
##D###C#
##.###c#
##.###.#
##b###d#
########