###########
#...###...#
#Ab.....aB#
#...###...#
###########