###############
#a............#
#b............#
############..#
#B............#
#A............#
###############
