########
#...A..#
##.###.#
##.###a#
##b###B#
########