########
#.bAaB.#
###.####
###.####
########