########
#..aABb#
##D###C#
##.###c#
##.###.#
##.###d#
########