###############
#a............#
#b............#
#c............#
#d............#
############..#
#D............#
#C............#
#B............#
#A............#
###############
